11111111111111111111111111111111111111111111111111111111111111111111111111111111
11111111111111111111111111111111111111111111111111111111111111111111111111111111
11111111111111111111111111111111111111111111111111111111111111111111111111111111
11111111111111111111111111111111111111111111111111111111111111111111111111111111
11111111220000000000000000000000000000022000000000000000000000000000002211111111
11111111220000000000000000000000000000022000000000000000000000000000002211111111
11111111003333333357777777330000000333333333300000000000000000333333330011111111
11111111003333333357777777330000000333333333300000000000000000333333330011111111
11111111003357777777777733003333300000033777775333333300000066666666330011111111
11111111003357777777777733003333300000033777775333333300000066666666330011111111
11111111003357777777773300003344440000033777777777753300444466666666330011111111
11111111003357777777773300003344440000033777777777753300444466666666330011111111
11111111003357777777773300003344443300033777777777753300444466666666330011111111
11111111003357777777773300666666443300033777777777753300444466666666330011111111
11111111000003333000000000666666000000000000000000000000444444440000000011111111
11111111000003333000000000666666000000000000000000000000444444440000000011111111
11111111550000000000000000666666000000033000000000000000444444440000000011111111
11111111550000000000000000666666000000033000000000000000444444440000000011111111
11111111550000000033333300000000000003333330000000000033333333330000000011111111
11111111550000000033333300000000000003333330000000000033333333330000000011111111
11111111550000000033333300000000000333333333300000000000333333000000005511111111
11111111550000000033333300000000000333333333300000000000333333000000005511111111
11111111550000003333333333333333333333333333333333333333333333330000005511111111
11111111550000003333333333333333333333333333333333333333333333330000005511111111
11111111000000333333333300000000000444433444400000000000333333333300000011111111
11111111000000333333333300000000000444433444400000000000333333333300000011111111
11111111000000003333330000005555550004444440005555550000003333330000000011111111
11111111000000003333330000005555550004444440005555550000003333330000000011111111
11111111006655000033000055555555550000044000005555555555000033000055660011111111
11111111006655000033000055555555550000044000005555555555000033000055660011111111
11111111006666550000005566550000000000000000000000005566550000005566660011111111
11111111006666550000005566550000333330000333333300005566550000005566660011111111
11111111006666665555556666000000333330000333333300000066665555556666660011111111
11111111006666665555556666000033333333333333333333000066665555556666660011111111
11111111006666666655666666000033333333333333333333000066666655666666660011111111
11111111006666666655666666003333333333333333333333330066666655666666660011111111
11111111006666666666666666003333333333333333333333330066666666666666660011111111
11111111006666666666666666004444444444444444444433330066666666666666660011111111
11111111006666666666666666004444444444444444444433330066666666666666660011111111
11111111006666666666666666444400000000000000004444330066666666666666660011111111
11111111000000000000000000444400000000000000004444330000000000000000000011111111
11111111000000000000000000440055000000005500004444440000000000000000000011111111
11111111003333333333333300440055000000005500004444440033333333333333330011111111
11111111003333333333333300440055000000005500004444440033333333333333330011111111
11111111000000000033330000440055000000005500004444440000333300000000000011111111
11111111000000000033330000440000004444000000444444333300333300000000000011111111
11111111000044330000330000440000004444000000444444333300333300003344000011111111
11111111000044330000330000444444444444444444444433333300333300003344000011111111
11111111004444333300000000444444444444444444444433333300000000333344440011111111
11111111004444333300000000334444443333444444443333333300000000333344440011111111
11111111444400553333000000334444443333444444443333333300000033335500444411111111
11111111444400553333000000003333333333333333333333330000000033335500444411111111
11111111444400555533330000003333333333333333333333330000003333555500444411111111
11111111444400555533330000000033333333333333333333000000003333555500444411111111
11111111004400004444333300000033333333333333333333000000333344440000440011111111
11111111004400004444333300000033333300022000333333000000333344440000440011111111
11111111004444444400333333330033333300022000333333003333333300444444440011111111
11111111004444444400333333330000000000333300000000003333333300444444440011111111
11111111000044440000000000000000000000300300000000000000000000004444000011111111
11111111000044440000000000000000000000300300000000000000000000004444000011111111